3 13 31
###############################
#p  * **    *#*   *#*  #*#2  *#
#  *# * #  *   * *   *  # #   #
# # # # * *  ###*###  *   2f  #
#   *** # *1          *  #*#  #
# # # # * *###########*   **  #
#       #  #    s    #  # # # #
#   *1*  *  #       *  *  *  1#
#  * # #  #  *##*##*  * ** *  #
#  # s *   *  * x *  #*#**#*  #
#*  * #  *  #  # *  s  **#*  *#
# b  *  1 ** #  *  #    #*  f #
###############################
