2 13 31
###############################
#p   *        *  ** * *     1*#
# #*# # #*# # # # # # # # #*# #
#**   * * *      1   *    **  #
#*# # # # # # # #f# # # # # #x#
# **       *     **     2*  **#
# # #*# # # # # #*#*#*#*# # # #
#   *        *   * *2* *      #
# # # # #*# # # # # # #*# #*# #
#   ****         *1           #
# # # # # # # # # #*# # # # #*#
#1         *   *  *           #
###############################