1 13 31
###############################
#p    * **    *   1           #
# # # #*# # # # # # # # # # # #
#      ** * *  *   * ** 1 *   #
# # # # # #*# # # # # # #*# # #
#*   * *    *s* *   **        #
# # # # # # # # # # # # # #*# #
#    *     *        *    **  1#
# #*# # #*#*#*#*# # # # # #*# #
#        * 1 * *    *   *     #
#*# # # # # # # # # # #*# # #*#
#x*    * **    ** ***     1   #
###############################