2 13 31
###############################
#p   ** **    *   1           #
# # # #*# # # # # # # # # # # #
#*     ** * *  *   * ** 2 *   #
# # # # # #*# # # # # # #*# # #
#*   *s*    *** *   **        #
# # # # # # # # # # # # # #*# #
#    *     *        *    **  1#
# #*# # #*#x#*#*# # #1# # #*# #
#        *   *2*    *   *     #
#*# # # # # #   # # # #*# # #*#
# *    * **    ** ***     1   #
###############################