1 13 31
###############################
#p     ** *    *   *  * * *  2#
# # # #*# # #*#*# # # #*#*#*# #
#   *     ***  *      *   * * #
# #  # # * * ### *   ### * #* #
#f   # #   1 #    *   # 1     #
# #  #1#   * ###  *   # * # # #
#*   # #*    #  *     #       #
# #  ###*    ### *#*  #   # # #
#*    **  *       *           #
# #*# # # # # # #*# #*# #*# # #
#x          *1  *  *  x     2 #
###############################