4 13 31
###############################
#p      ** 1  *      *  1   * #
# # # # # #*#*#*#*# #*# # # # #
#   **          2 *      *    #
# # # ##### ##### ##### #*# #*#
# *   #   #*#   #*#   #*      #
# # # #   # #   # ##### # # # #
#** b #   #*#   #*#  1 *  *   #
# # # ##### ##### #***  # # # #
#    *     *     *            #
# # # #*#*# #*#*# #*#*# # # # #
#   *        *x   2   *   *   #
###############################