4 13 31
###############################
#p     * 1     *      *  1    #
# #*#*# # # ####### # #*#*#*#*#
#   *       #  1  #           #
#*# # # ##### # # ##### # # # #
#  **   #             #   **  #
#b# #*#*# #*# #x# #*# #*#*# # #
#    *  #      1      #   1   #
# #*# # ##### # # ##### # # # #
#     *     #     #    ** 1   #
#*# # # #*# ####### # #*# # # #
#  1 *         f          **  #
###############################