1 13 31
###############################
#p     **1*    *   *  * * *   #
#*  # #*# # #*#*# # # #*#x#*# #
#   *     ***  *      *   * * #
# # # # # #*# # #*#*# # #1# #*#
#            **  *  *         #
# #  * *#  ** *** #*# #*# # # #
#*  *      *  *1     *        #
# # # # #*# # # #*#*#1 **   * #
#*    **  *       *           #
# #*# # * # # # #*# # * # # * #
# b      1  *   *  *          #
###############################
